11111111111111111111111111111
1_____________1_____________1
111111111__1111_____________1
1___________________________1
1___________________________1
1__111111111111111__________1
1_________1_________________1
1_________1_________________1
1____1____1_________________1
1____1____1111111111___1111_1
1____1_________________1____1
1____1111111111________1____1
1______________________11_111
11111111111111111111111111111